17 13
|w|w|w|w|w|w|w|w|w|w|w|w|w|w|w|w|w
|w|p| |w|g|g|r|d|g|d|g|g|g|g|g|g|w
|w|w|g|w|g|g|d|g|g|w|g|r|g|d|d|g|w
|w|w|g|w|r|g|g|w|g|g|g|g|g|g|g|w|w
|w|d|g|w|g|g|g|w|g|r|g|r|g|d|r|g|w
|w|g|g|w|g|g|g|w|r|r|g|g|g|g|g|g|w
|w|g|g|r| |g|g|w|w|w|w|w|w|g|g|g|w
|w|w|w|w| | |g|w|g|g|g|d|r|g|g|g|w
|w|g|g|g|r| | |w|g|r|g|g|r|d|r|g|w
|w|g|g|g|g|r| |w|g|d|g|g|g|g|g|g|w
|w|g|g|g|g|g| |w|g|g|r|g|g|g|g|g|w
|w|g|g|g|g|g|r|w|g|g|g|g|d|g|g|e|w
|w|w|w|w|w|w|w|w|w|w|w|w|w|w|w|w|w