7 7
|w|w|w|w|w|w|w
|w|g| |r|r|e|w
|w|g|p| | | |w
|w|g|d| |r| |w
|w| |g|g| | |w
|w|d|d| | | |w
|w|w|w|w|w|w|w