17 13
|w|w|w|w|w|w|w|w|w|w|w|w|w|w|w|w|w
|w|p|0|w|0| |0|d| |d| | | | | | |w
|w|w| |w|0|0|0| | |w| |r| |d|d| |w
|w|w| |w|0|e|0|w| | | | | | | |w|w
|w|d| |w|0|0|0|w| |r| |r| |d|r| |w
|w| | |w| | | |w|r|r| | | | | | |w
|w| | |r|0|0|0|w|w|w|w|w|w| | | |w
|w|w|w|w|0|0|0|w| | | |d|r| | | |w
|w| | | |r|0|0|w| |r| | |r|d|r| |w
|w| | | | |r|0|w| |d| | | | | | |w
|w| | | | | |0|w| | |r| | | | | |w
|w| | | | | |r|w| | | | |d| | |f|w
|w|w|w|w|w|w|w|w|w|w|w|w|w|w|w|w|w
